#############
# ==========#
#===========#
#===========#
#===========#
#===========#
#===========#
#===========#
#===========#
#===========#
#===========#
#############